+---+---+---+---+---+
|       |           |
+   +   +   +---+   +
|   |           |   |
+   +---+---+---+   +
|                   |
+---+---+---+---+---+