+---+---+---+
|           |
+   +---+   +
|   |   |   | 
+   +   +   +
|       |   |
+---+   +   +
|       |   |
+   +---+   +
|           |
+---+---+---+