+---+---+---+---+---+---+---+---+---+---+---+---+---+---+---+---+---+---+---+---+---+---+---+---+---+---+---+
|                                                   |   |                                                   |
+   +   +   +   +   +   +   +   +   +   +   +   +   +   +   +   +   +   +   +   +   +   +   +   +   +   +   +
|                                                   |   |                                                   |
+   +   +---+---+---+   +   +---+---+---+---+   +   +   +   +   +---+---+---+---+   +   +---+---+---+   +   +
|       |           |       |               |       |   |       |               |       |           |       |
+   +   +   +   +   +   +   +   +   +   +   +   +   +   +   +   +   +   +   +   +   +   +   +   +   +   +   +
|       |           |       |               |       |   |       |               |       |           |       |
+   +   +---+---+---+   +   +---+---+---+---+   +   +---+   +   +---+---+---+---+   +   +---+---+---+   +   +
|                                                                                                           |
+   +   +   +   +   +   +   +   +   +   +   +   +   +   +   +   +   +   +   +   +   +   +   +   +   +   +   +
|                                                                                                           |
+   +   +---+---+---+   +   +---+   +   +---+---+---+---+---+---+---+   +   +---+   +   +---+---+---+   +   +
|       |           |       |   |       |                           |       |   |       |           |       |
+   +   +---+---+---+   +   +   +   +   +---+---+---+   +---+---+---+   +   +   +   +   +---+---+---+   +   +
|                           |   |                   |   |                   |   |                           |
+   +   +   +   +   +   +   +   +   +   +   +   +   +   +   +   +   +   +   +   +   +   +   +   +   +   +   +
|                           |   |                   |   |                   |   |                           |
+---+---+---+---+---+   +   +   +---+---+---+   +   +   +   +   +---+---+---+   +   +   +---+---+---+---+---+
|                   |       |               |       |   |       |               |       |                   |
+   +   +   +   +   +   +   +   +---+---+---+   +   +---+   +   +---+---+---+   +   +   +   +   +   +   +   +
|                   |       |   |                                           |   |       |                   |
+   +   +   +   +   +   +   +   +   +   +   +   +   +   +   +   +   +   +   +   +   +   +   +   +   +   +   +
|                   |       |   |                                           |   |       |                   |
+   +   +   +   +   +   +   +   +   +   +---+---+---+---+---+---+---+   +   +   +   +   +   +   +   +   +   +
|                   |       |   |       |                           |       |   |       |                   |
+---+---+---+---+---+   +   +---+   +   +   +   +   +   +   +   +   +   +   +---+   +   +---+---+---+---+---+
|                                       |                           |                                       |
+   +   +   +   +   +   +   +   +   +   +   +   +   +   +   +   +   +   +   +   +   +   +   +   +   +   +   +
|                                       |                           |                                       |
+---+---+---+---+---+   +   +---+   +   +   +   +   +   +   +   +   +   +   +---+   +   +---+---+---+---+---+
|                   |       |   |       |                           |       |   |       |                   |
+   +   +   +   +   +   +   +   +   +   +---+---+---+---+---+---+---+   +   +   +   +   +   +   +   +   +   +
|                   |       |   |                                           |   |       |                   |
+   +   +   +   +   +   +   +   +   +   +   +   +   +   +   +   +   +   +   +   +   +   +   +   +   +   +   +
|                   |       |   |                                           |   |       |                   |
+   +   +   +   +   +   +   +   +   +   +---+---+---+---+---+---+---+   +   +   +   +   +   +   +   +   +   +
|                   |       |   |       |                           |       |   |       |                   |
+---+---+---+---+---+   +   +---+   +   +---+---+---+   +---+---+---+   +   +---+   +   +---+---+---+---+---+
|                                                   |   |                                                   |
+   +   +   +   +   +   +   +   +   +   +   +   +   +   +   +   +   +   +   +   +   +   +   +   +   +   +   +
|                                                   |   |                                                   |
+   +   +---+---+---+   +   +---+---+---+---+   +   +   +   +   +---+---+---+---+   +   +---+---+---+   +   +
|       |           |       |               |       |   |       |               |       |           |       |
+   +   +---+---+   +   +   +---+---+---+---+   +   +---+   +   +---+---+---+---+   +   +   +---+---+   +   +
|               |   |                                                                   |   |               |
+   +   +   +   +   +   +   +   +   +   +   +   +   +   +   +   +   +   +   +   +   +   +   +   +   +   +   +
|               |   |                                                                   |   |               |
+---+---+   +   +   +   +   +---+   +   +---+---+---+---+---+---+---+   +   +---+   +   +   +   +   +---+---+
|       |       |   |       |   |       |                           |       |   |       |   |       |       |
+---+---+   +   +---+   +   +   +   +   +---+---+---+   +---+---+---+   +   +   +   +   +---+   +   +---+---+
|                           |   |                   |   |                   |   |                           |
+   +   +   +   +   +   +   +   +   +   +   +   +   +   +   +   +   +   +   +   +   +   +   +   +   +   +   +
|                           |   |                   |   |                   |   |                           |
+   +   +---+---+---+---+---+   +---+---+---+   +   +   +   +   +---+---+---+   +---+---+---+---+---+   +   +
|       |                                   |       |   |       |                                   |       |
+   +   +---+---+---+---+---+---+---+---+---+   +   +---+   +   +---+---+---+---+---+---+---+---+---+   +   +
|                                                                                                           |
+   +   +   +   +   +   +   +   +   +   +   +   +   +   +   +   +   +   +   +   +   +   +   +   +   +   +   +
|                                                                                                           |
+---+---+---+---+---+---+---+---+---+---+---+---+---+---+---+---+---+---+---+---+---+---+---+---+---+---+---+