6,6
+---+---+---+---+---+---+
|   |           |       |
+   +---+---+   +   +   +
|   |           |       |
+   +   +---+---+   +   +
|       |       |   |   |
+---+   +   +   +   +   +
|   |       |   |   |   |
+   +   +---+---+---+   +
|   |       |   |   |   |
+   +---+   +   +   +   +
|                       |
+---+---+---+---+---+---+
